####################
#....p.....#.......#
#.########.#.#####.#
t..................t
#.####.####.####.#.#
#....#c#  #....#.#.#
#o####m#  #r####o#o#
#.#...y#  #.#....#.#
#.####.####.####.#.#
t..................t
#.########.#.#####.#
#..........#.......#
####################